# This is a collection of misspellings and the intended word gathered from
# a variety of sources.

# From FAWTHROP1DAT.643
abbatoir|abattoir
abhorence|abhorrence
absense|absence
absorbant|absorbent
absorbtion|absorption
acceed|accede
acellerate|accelerate
accesible|accessible
accidently|accidentally
accomodate|accommodate
accomodation|accommodation
accomodations|accommodations
accompanimen|accompaniment
accompaning|accompanying
acomplice|accomplice
accrude|accrued
acrued|accrued
acumulated|accumulated
acustom|accustom
acheivement|achievement
acknowledgement|acknowledgment
acquantance|acquaintance
aquiese|acquiesce
acquiesence|acquiescence
aquire|acquire
actualy|actually
adaptibility|adaptability
additon|addition
adress|address
adaquately|adequately
ajacent|adjacent
adjorned|adjourned
adminstration|administration
admissable|admissible
admiting|admitting
advantagous|advantageous
advise|advice
afidavit|affidavit
agravated|aggravated
agast|aghast
agreable|agreeable
alloted|allotted
allso|also
alumni|alumnae
alumnae|alumni
amatuer|amateur
aimeable|amiable
aimiable|amiable
amonia|ammonia
analagous|analogous
anaylsis|analysis
analize|analyze
angell|angel
aniversary|anniversary
anniversery|anniversary
anouncement|announcement
annoiance|annoyance
anoyance|annoyance
anwser|answer
antartic|antarctic
anye|any
anythin|anything
appolo|apollo
appology|apology
aparent|apparent
appearence|appearance
appearin|appearing
appitite|appetite
appatites|appetites
appropiate|appropriate
apropriate|appropriate
apropriation|appropriation
approxomate|approximate
aproximate|approximate
approximatly|approximately
aproximately|approximately
archeological|archaeological
acertain|ascertain
assertain|ascertain
assinine|asinine
askin|asking
asleeep|asleep
assasinate|assassinate
assesment|assessment
assidious|assiduous
assistence|assistance
attornies|attorneys
authorative|authoritative
auxillary|auxiliary
avaliable|available
aukward|awkward
batchelor|bachelor
baloon|balloon
bananna|banana
bankrupcy|bankruptcy
baragining|bargaining
batallion|battalion
beame|beam
beefore|before
begining|beginning
beleive|believe
beligerant|belligerent
beneficient|beneficent
benificial|beneficial
bich|bitch
brakke|brake
bretheren|brethren
brieff|brief
britian|britain
britania|britannia
broun|brown
bungalo|bungalow
bouyancy|buoyancy
bouyant|buoyant
burried|buried
bushell|bushel
businesss|business
busness|business
buyin|buying
cancelation|cancellation
callin|calling
cantaloube|cantaloupe
carribean|caribbean
catologues|catalogues
catagorey|category
cemetary|cemetery
chauffuer|chauffeur
chemestry|chemistry
chimnies|chimneys
cincinatti|cincinnati
cleva|clever
coalesed|coalesced
coherant|coherent
colosium|coliseum
calateral|collateral
collosal|colossal
collosus|colossus
commaunded|commanded
commision|commission
committment|commitment
commitee|committee
comunicate|communicate
comparitive|comparative
comparitively|comparatively
conpendium|compendium
competant|competent
compitent|competent
consede|concede
concieve|conceive
concieved|conceived
condicions|conditions
confectionary|confectionery
confermation|confirmation
confusin|confusing
connoiseurs|connoisseurs
concience|conscience
conscientous|conscientious
concensus|consensus
consderin|considering
consistant|consistent
conpired|conspired
comsumer|consumer
contempible|contemptible
continious|continuous
continous|continuous
controlable|controllable
controvercy|controversy
controversey|controversy
conviently|conveniently
cooly|coolly
corderoy|corduroy
correspondance|correspondence
corrigated|corrugated
coud|could
countin|counting
countriman|countryman
craftman|craftsman
curiousity|curiosity
curicculum|curriculum
customery|customary
synical|cynical
darlin|darling
dicidely|decidedly
deam|deem
definately|definitely
definatly|definitely
deliguent|delinquent
delinquint|delinquent
dilirious|delirious
delvin|delving
denyin|denying
dependent|dependant
depeciation|depreciation
descendent|descendant
discription|description
dispair|despair
duece|deuce
devellope|develop
developement|development
dictionery|dictionary
dignatary|dignitary
dilapadated|dilapidated
diminsh|diminish
dinning|dining
diptheria|diphtheria
dessapoint|disappoint
disapoint|disappoint
dissapoint|disappoint
dissappoint|disappoint
dissappointment|disappointment
disasterous|disastrous
discpline|discipline
discreet|discrete
dispell|dispel
disippate|dissipate
devine|divine
docter|doctor
docters|doctors
dormatory|dormitory
doubte|doubt
drasticly|drastically
drawin|drawing
dreamin|dreaming
drewe|drew
droped|dropped
drunkeness|drunkenness
dutchess|duchess
duely|duly
durin|during
ernest|earnest
ecstacy|ecstasy
effectinge|effecting
affeminate|effeminate
effervesent|effervescent
effeciency|efficiency
eisenhhower|eisenhower
eligble|eligible
elliminate|eliminate
illiminate|eliminate
embarass|embarrass
embarassment|embarrassment
embarrasment|embarrassment
enclyclopedia|encyclopedia
encylopedia|encyclopedia
endorsment|endorsement
emeny|enemy
egnineers|engineers
enlargd|enlarged
enterteyned|entertained
equipt|equipped
equivelant|equivalent
estimed|esteemed
evrey|every
exagerate|exaggerate
exageration|exaggeration
examiantion|examination
examinin|examining
excelence|excellence
excercises|exercises
exhilirating|exhilarating
exorted|exhorted
existance|existence
exhorbitant|exorbitant
experiance|experience
explisitly|explicitly
exquiset|exquisite
exqusite|exquisite
eying|eyeing
facilatate|facilitate
facinating|fascinating
fatiging|fatiguing
feare|fear
febuary|february
fictitous|fictitious
fiedler|fielder
firey|fiery
fieghting|fighting
philipinoes|filipinos
filthness|filthiness
finaly|finally
flamable|flammable
florished|flourished
foriegn|foreign
fortright|forthright
fourty|forty
foxx|fox
frescoes|frescos
freind|friend
fullfil|fulfill
fundemental|fundamental
fundementally|fundamentally
gardner|gardener
guage|gauge
generousity|generosity
genious|genius
gastly|ghastly
knawing|gnawing
gonne|gone
goverment|government
grabbin|grabbing
grammer|grammar
grammophon|gramophone
granduer|grandeur
greatful|grateful
grievious|grievous
grille|grill
gaurantee|guarantee
guarenteed|guaranteed
gaurdian|guardian
guardien|guardian
gutteral|guttural
hammerskjold|hammarskjold
hande|hand
hankerchief|handkerchief
hansome|handsome
harrass|harass
haveing|having
heartrendering|heartrending
heighth|height
hienous|heinous
hemorrage|hemorrhage
heydey|heyday
himselfe|himself
hinderance|hindrance
hinderence|hindrance
humly|humbly
huricane|hurricane
hygeine|hygiene
indentified|identified
idiocyncracy|idiosyncrasy
imaganation|imagination
imagnation|imagination
immitation|imitation
immediatley|immediately
immencely|immensely
immensly|immensely
impedence|impedance
impressario|impresario
insense|incense
incesant|incessant
incidently|incidentally
incompatability|incompatibility
inconvience|inconvenience
incorigible|incorrigible
incredable|incredible
indefinate|indefinite
independance|independence
inditement|indictment
indispensible|indispensable
inevitible|inevitable
infalable|infallible
infinate|infinite
ingratitoode|ingratitude
inocuous|innocuous
innoculate|inoculate
insistance|insistence
instantanous|instantaneous
insted|instead
intersede|intercede
interferred|interfered
intereference|interference
interupted|interrupted
invarably|invariably
irrevelant|irrelevant
irrepairable|irreparable
irristible|irresistible
itimized|itemized
jacknife|jackknife
jagaur|jaguar
japaneze|japanese
jaundise|jaundice
jelousy|jealousy
jeprodise|jeopardize
judgement|judgment
kaleidescope|kaleidoscope
kaliedoscope|kaleidoscope
kapock|kapok
kahki|khaki
kimona|kimono
kindergarden|kindergarten
kitchin|kitchen
knicknacks|knickknacks
labelled|labeled
labortory|laboratory
labratory|laboratory
langauge|language
leaway|leeway
leasure|leisure
liesure|leisure
levelled|leveled
libary|library
libray|library
lisence|license
leutenant|lieutenant
linolium|linoleum
liquified|liquefied
liquify|liquefy
livlihood|livelihood
loadstone|lodestone
lodgement|lodgment
lonley|lonely
magnificant|magnificent
magnificient|magnificent
magnigicient|magnificent
maintainance|maintenance
mamoth|mammoth
managment|management
manuveur|maneuver
manufacturies|manufactories
masterpice|masterpiece
materiel|material
mathamatics|mathematics
mathmatics|mathematics
matress|mattress
mattres|mattress
mauldin|maudlin
ment|meant
medecine|medicine
meetin|meeting
mercanery|mercenary
merchandize|merchandise
merchantment|merchantmen
meterological|meteorological
metropolitian|metropolitan
millionnaire|millionaire
minature|miniature
miscelaneous|miscellaneous
mischievious|mischievous
mocassins|moccasins
momentus|momentous
morgage|mortgage
mortgauged|mortgaged
murmers|murmurs
musnt|mustnt
mutalate|mutilate
mithical|mythical
nadar|nadir
naphta|naphtha
naptha|naphtha
narative|narrative
naturaly|naturally
navagating|navigating
necessarially|necessarily
necessarilly|necessarily
neccesary|necessary
niagra|niagara
nickle|nickel
nigardly|niggardly
nintieth|ninetieth
nintynineth|ninetyninth
nocternal|nocturnal
nonsence|nonsense
nothwithstanding|notwithstanding
nowdays|nowadays
obliggato|obbligato
obdirate|obdurate
ocassion|occasion
ocassionaly|occasionally
occasionly|occasionally
occassionally|occasionally
occured|occurred
occurence|occurrence
octapus|octopus
oddysey|odyssey
omenous|ominous
ommision|omission
onirous|onerous
oppurtunities|opportunities
oposition|opposition
oppresser|oppressor
opticion|optician
optitian|optician
orotario|oratorio
ochestra|orchestra
ordinarilly|ordinarily
origen|origin
orginally|originally
origionally|originally
owne|own
paine|pain
pamphalet|pamphlet
pamplet|pamphlet
phamplet|pamphlet
pamplets|pamphlets
phamplets|pamphlets
parellel|parallel
parallysis|paralysis
parephernalia|paraphernalia
parenthasis|parenthesis
participal|participle
pasttime|pastime
paster|pastor
paternaty|paternity
pavillion|pavilion
peasent|peasant
pecular|peculiar
pennance|penance
pendelum|pendulum
pengiuns|penguins
peninsular|peninsula
penitentary|penitentiary
percieve|perceive
preforation|perforation
permisable|permissible
permissable|permissible
perserverance|perseverance
perseverence|perseverance
personality|personalty
persperation|perspiration
pursuade|persuade
pursuaded|persuaded
persausion|persuasion
pertaning|pertaining
prevaded|pervaded
pharoahs|pharaohs
fase|phase
faze|phase
phenominal|phenomenal
phenonenon|phenomenon
phillipines|philippines
phisician|physician
physcian|physician
physican|physician
pickeral|pickerel
picnicing|picnicking
pittsburg|pittsburgh
plaigarism|plagiarism
placque|plaque
playwrite|playwright
plesant|pleasant
poetrie|poetry
poisenous|poisonous
pondorous|ponderous
posess|possess
posession|possession
possesion|possession
posiblities|possibilities
possiblities|possibilities
prarie|prairie
preceeding|preceding
presipice|precipice
preferrable|preferable
preferance|preference
prefered|preferred
predjudice|prejudice
predudice|prejudice
prejedice|prejudice
preperation|preparation
perserved|preserved
presumptous|presumptuous
prevelant|prevalent
preventative|preventive
prisner|prisoner
privelege|privilege
priviledge|privilege
probabley|probably
proceedure|procedure
proffesor|professor
profer|proffer
prominant|prominent
promonotory|promontory
pronounciation|pronunciation
propellor|propeller
prophesy|prophecy
provisons|provisions
pseudynom|pseudonym
psycological|psychological
publick|public
publically|publicly
pumkin|pumpkin
persue|pursue
persuer|pursuer
persuit|pursuit
qualafied|qualified
quandry|quandary
quanties|quantities
quarrantine|quarantine
quarelled|quarreled
quater|quarter
questionaire|questionnaire
quiscent|quiescent
quorem|quorum
radient|radiant
radiater|radiator
raize|raise
rateing|rating
realy|really
rebutal|rebuttal
receeded|receded
reciept|receipt
receits|receipts
reciepts|receipts
receave|receive
recieve|receive
reciever|receiver
receptacel|receptacle
resipient|recipient
reciprocel|reciprocal
recon|reckon
reclaimation|reclamation
reccommend|recommend
reccommendation|recommendation
reccomendations|recommendations
reccomended|recommended
reccommended|recommended
recommend|recommended
reccomending|recommending
reccommending|recommending
recompence|recompense
redundent|redundant
referance|reference
refered|referred
refering|referring
refrigerater|refrigerator
regreted|regretted
rehabilatate|rehabilitate
revelent|relevant
religous|religious
rememberance|remembrance
rendevous|rendezvous
renagade|renegade
renoun|renown
repairation|reparation
repell|repel
repitition|repetition
represenatives|representatives
representitives|representatives
resinded|rescinded
resevoir|reservoir
responsiblity|responsibility
restuarant|restaurant
restauranteur|restaurateur
raphsody|rhapsody
rhuematism|rheumatism
rhododrendon|rhododendron
ruhbarb|rhubarb
rythm|rhythm
rediculous|ridiculous
romantick|romantic
rumage|rummage
runing|running
sabath|sabbath
sacrement|sacrament
sacreligious|sacrilegious
safty|safety
sagatious|sagacious
sailer|sailor
sanwich|sandwich
sanatary|sanitary
satisfactary|satisfactory
scarsity|scarcity
scisors|scissors
sissers|scissors
sieze|seize
siezed|seized
selfe|self
selle|sell
semisters|semesters
seminery|seminary
seperate|separate
sergant|sergeant
sheepe|sheep
sheperd|shepherd
silhuette|silhouette
shippin|shipping
shouldda|shoulder
sholders|shoulders
showin|showing
shrubery|shrubbery
seige|siege
significent|significant
silke|silk
similiar|similar
similtanous|simultaneous
sincerety|sincerity
slimest|slimmest
smilin|smiling
socable|sociable
socal|social
solmn|solemn
solomn|solemn
sophmore|sophomore
sarrority|sorority
sororiety|sorority
saught|sought
sourse|source
souviner|souvenir
sovreignty|sovereignty
sparcely|sparsely
speer|spear
specificly|specifically
speciman|specimen
speciment|specimen
specimans|specimens
spiritous|spirituous
sprinkel|sprinkle
startin|starting
stationery|stationary
statu|statue
stirrin|stirring
stirups|stirrups
stomack|stomach
strainin|straining
straightjacket|straitjacket
strategem|stratagem
stratagy|strategy
streneous|strenuous
strenous|strenuous
streched|stretched
stubborness|stubbornness
sububan|suburban
sucess|success
sufficent|sufficient
sufferage|suffrage
suger|sugar
sueing|suing
superfical|superficial
supertendent|superintendent
supercede|supersede
suplement|supplement
supliment|supplement
supress|suppress
suprise|surprise
sureptitous|surreptitious
surounded|surrounded
swearinge|swearing
sylables|syllables
symetry|symmetry
synonomous|synonymous
systemetically|systematically
tasit|tacit
takin|taking
technecally|technically
televison|television
temperment|temperament
temporarly|temporarily
temperary|temporary
tendancy|tendency
terestial|terrestrial
terrours|terrors
thatt|that
therefor|therefore
theaf|thief
thinke|think
thinkin|thinking
thourough|thorough
thouroughly|thoroughly
throughly|thoroughly
tobbaco|tobacco
tobboganing|tobogganing
tonage|tonnage
tradegy|tragedy
tradgedy|tragedy
tranquillity|tranquility
tranquility|tranquillity
transferrable|transferable
transfered|transferred
trucculent|truculent
truley|truly
tieing|tying
tyranical|tyrannical
undoubtably|undoubtedly
undoubtly|undoubtedly
unequalled|unequaled
unfortunatly|unfortunately
universaty|university
unmistakeable|unmistakable
unparalelled|unparalleled
untill|until
useage|usage
usualy|usually
usurous|usurious
utterence|utterance
vacency|vacancy
vancancy|vacancy
vacinnation|vaccination
vaccilate|vacillate
vairous|various
vegatable|vegetable
vengance|vengeance
verticle|vertical
vise|vice
vituals|victuals
villify|vilify
villian|villain
violance|violence
vioiln|violin
visable|visible
vitamines|vitamins
vouture|voucher
waggin|wagging
wagish|waggish
wedensday|wednesday
wensday|wednesday
weede|weed
weigth|weight
wierd|weird
wheather|whether
whitch|which
whoe|who
withold|withhold
worshipping|worshiping
yahct|yacht
yaht|yacht
yerned|yearned
yoman|yeoman
yeild|yield
zelous|zealous
zeenith|zenith

# From WebKit
abandonned|abandoned
abilties|abilities
abilty|ability
abondon|abandon
abondoned|abandoned
abondoning|abandoning
absense|absence
absolutly|absolutely
acadamy|academy
acadmic|academic
accademic|academic
accademy|academy
acccused|accused
acceptence|acceptance
acceptible|acceptable
accessable|accessible
accidentaly|accidentally
accidently|accidentally
accomadate|accommodate
accomdate|accommodate
accomodate|accommodate
accompanyed|accompanied
accoring|according
accquainted|acquainted
accross|across
accussed|accused
acedemic|academic
acheive|achieve
acheived|achieved
acheivement|achievement
acheivements|achievements
acheiving|achieving
acheivment|achievement
acheivments|achievements
achievment|achievement
achievments|achievements
achive|achieve
achived|achieved
achivement|achievement
achivements|achievements
acknowldeged|acknowledged
acknowledgeing|acknowledging
ackward|awkward
acommodate|accommodate
acomplish|accomplish
acomplished|accomplished
acomplishment|accomplishment
acomplishments|accomplishments
acording|according
acordingly|accordingly
acquaintence|acquaintance
acquaintences|acquaintances
acquiantence|acquaintance
acquiantences|acquaintances
activites|activities
activly|actively
actualy|actually
acuracy|accuracy
acused|accused
acustommed|accustomed
adavanced|advanced
adbandon|abandon
addmission|admission
addopt|adopt
addopted|adopted
addres|address
addresed|addressed
addresing|addressing
addressess|addresses
addtion|addition
addtional|additional
adecuate|adequate
admendment|amendment
admininistrative|administrative
adminstration|administration
adminstrative|administrative
adminstrator|administrator
admited|admitted
admitedly|admittedly
adn|and
adolecent|adolescent
adquire|acquire
adquired|acquired
adquiring|acquiring
adres|address
adresing|addressing
adress|address
adressed|addressed
adressing|addressing
advertisment|advertisement
advertisments|advertisements
advesary|adversary
adviced|advised
afair|affair
affilate|affiliate
affilliate|affiliate
affort|afford
aforememtioned|aforementioned
againnst|against
agains|against
agaisnt|against
aganist|against
aggreed|agreed
aggreement|agreement
aggresive|aggressive
agian|again
agianst|against
agin|again
agina|again
aginst|against
agre|agree
agred|agreed
agreeement|agreement
agreemnt|agreement
agregate|aggregate
agreing|agreeing
agressive|aggressive
agressively|aggressively
agricuture|agriculture
ahev|have
ahppen|happen
ahve|have
aicraft|aircraft
aiport|airport
aircaft|aircraft
aircrafts|aircraft
airporta|airports
airrcraft|aircraft
albiet|albeit
alchohol|alcohol
alchoholic|alcoholic
alchol|alcohol
alcholic|alcoholic
alcohal|alcohol
alcoholical|alcoholic
aledged|alleged
aleged|alleged
alledged|alleged
alledgedly|allegedly
allegedely|allegedly
allegedy|allegedly
allegely|allegedly
alligned|aligned
alliviate|alleviate
allready|already
allthough|although
alltogether|altogether
almsot|almost
alochol|alcohol
alomst|almost
alowed|allowed
alowing|allowing
alreayd|already
alse|else
alsot|also
alternitives|alternatives
altho|although
althought|although
altough|although
alusion|illusion
alwasy|always
alwyas|always
amatuer|amateur
amature|amateur
amendmant|amendment
amke|make
amking|making
ammended|amended
ammendment|amendment
ammount|amount
ammused|amused
amoung|among
amoungst|amongst
amung|among
anbd|and
aniversary|anniversary
annouced|announced
annualy|annually
anohter|another
anonimity|anonymity
anounced|announced
ansestors|ancestors
anual|annual
anwsered|answered
anyhwere|anywhere
anytying|anything
aparent|apparent
aparment|apartment
aplication|application
aplied|applied
apon|apron
apparant|apparent
apparantly|apparently
appart|apart
appartment|apartment
appartments|apartments
appealling|appealing
appeareance|appearance
appearence|appearance
appearences|appearances
apperance|appearance
apperances|appearances
appereance|appearance
appereances|appearances
applicaiton|application
applicaitons|applications
appologies|apologies
appology|apology
apprearance|appearance
apprieciate|appreciate
approachs|approaches
appropiate|appropriate
appropraite|appropriate
appropropiate|appropriate
approxamately|approximately
approxiately|approximately
approximitely|approximately
apropriate|appropriate
aproximately|approximately
aquaintance|acquaintance
aquainted|acquainted
aquiantance|acquaintance
aquire|acquire
aquired|acquired
aquiring|acquiring
aquisition|acquisition
aranged|arranged
arangement|arrangement
archetect|architect
archetecture|architecture
archictect|architect
architechture|architecture
aready|already
arent|aren't
argubly|arguably
arguement|argument
arguements|arguments
arised|arose
arival|arrival
arogant|arrogant
arogent|arrogant
aroud|around
arrangment|arrangement
arrangments|arrangements
arround|around
artical|article
artice|article
articel|article
artifical|artificial
arund|around
asign|assign
aslo|also
asociated|associated
asorbed|absorbed
assasin|assassin
assasinated|assassinated
assasination|assassination
assasined|assassinated
assassintation|assassination
assertation|assertion
asside|aside
assit|assist
assitant|assistant
assocation|association
assoicate|associate
assoicated|associated
assoicates|associates
assosication|assassination
assualt|assault
assualted|assaulted
asteriod|asteroid
asume|assume
atempting|attempting
atorney|attorney
atributed|attributed
attemp|attempt
attemped|attempted
attemt|attempt
attemted|attempted
attemting|attempting
attemts|attempts
attendence|attendance
attendent|attendant
attened|attended
attension|attention
attitide|attitude
attributred|attributed
audeince|audience
auromated|automated
auther|author
authorites|authorities
authorithy|authority
authoritiers|authorities
authrorities|authorities
automaticly|automatically
autor|author
autority|authority
availablity|availability
availaible|available
availble|available
availiable|available
availible|available
avalable|available
avaliable|available
avation|aviation
averageed|averaged
avilable|available
awared|awarded
awya|away
baceause|because
backgorund|background
bakc|back
bandwith|bandwidth
bankrupcy|bankruptcy
banruptcy|bankruptcy
baout|about
basicaly|basically
basicly|basically
bcak|back
beacuse|because
beatiful|beautiful
beautyfull|beautiful
becamae|became
becames|became
becasue|because
beccause|because
becomeing|becoming
becomming|becoming
becouse|because
becuase|because
bedore|before
befoer|before
beggin|begging
beggining|beginning
begginings|beginnings
beggins|begins
begining|beginning
beginnig|beginning
behavour|behavior
beleif|belief
beleive|believe
beleived|believed
beleives|believes
beleiving|believing
belive|believe
belived|believed
belives|beliefs
beng|being
benificial|beneficial
benifit|benefit
benifits|benefits
betwen|between
beween|between
bewteen|between
bizzare|bizarre
blaim|blame
blaimed|blamed
blessure|blessing
boaut|about
borke|broke
breakthough|breakthrough
breif|brief
breifly|briefly
briliant|brilliant
brillant|brilliant
broacasted|broadcast
broadacasting|broadcasting
broady|broadly
buisness|business
buisnessman|businessman
buring|burning
burried|buried
busineses|business
busness|business
bussiness|business
cacuses|caucuses
cahracters|characters
calaber|caliber
calander|calendar
caluclate|calculate
caluclated|calculated
caluculate|calculate
caluculated|calculated
calulate|calculate
calulated|calculated
campain|campaign
campains|campaigns
candadate|candidate
candiate|candidate
candidiate|candidate
cannnot|cannot
cant|can't
caost|coast
caperbility|capability
capible|capable
captial|capital
captued|captured
capturd|captured
carachter|character
caracterized|characterized
carefull|careful
careing|caring
carnege|carnage
carnige|carnage
carreer|career
carrers|careers
casulaties|casualties
catagories|categories
catagory|category
causalities|casualties
cementary|cemetery
cemetarey|cemetery
cemetary|cemetery
cencus|census
centruies|centuries
centruy|century
ceratin|certain
cerimonies|ceremonies
cerimony|ceremony
ceromony|ceremony
certainity|certainty
certian|certain
chalenging|challenging
challange|challenge
challanged|challenged
challege|challenge
Champange|Champagne
charachter|character
charachters|characters
charactors|characters
charaterized|characterized
chariman|chairman
charistics|characteristics
chasr|chase
cheif|chief
chemcial|chemical
chemestry|chemistry
cheque|check
childen|children
choosen|chosen
chracter|character
chuch|church
churchs|churches
circut|circuit
ciricuit|circuit
civillian|civilian
claer|clear
claerer|clearer
claerly|clearly
claimes|claims
clas|class
clasic|classic
clera|clear
clincial|clinical
cmoputer|computer
coctail|cocktail
colateral|collateral
colelctive|collective
collecton|collection
collegue|colleague
collegues|colleagues
comander|commander
comany|company
comapany|company
comback|comeback
comision|commission
comisioner|commissioner
comission|commission
comissioner|commissioner
comited|committed
comiting|committing
comitted|committed
comittee|committee
comitting|committing
commerical|commercial
commericial|commercial
comming|coming
comminication|communication
commision|commission
commisioner|commissioner
commited|committed
commitee|committee
commiting|committing
committe|committee
committment|commitment
committments|commitments
commongly|commonly
commuications|communications
commuinications|communications
communciation|communication
communiation|communication
communites|communities
comparision|comparison
compatable|compatible
compatiable|compatible
compeitions|competitions
compensantion|compensation
competative|competitive
competion|competition
competitiion|competition
competive|competitive
comphrehensive|comprehensive
completelyl|completely
completetion|completion
componant|component
comprable|comparable
comprimise|compromise
concensus|consensus
concider|consider
concidered|considered
concidering|considering
conciders|considers
concieved|conceived
concious|conscious
conciously|consciously
conciousness|consciousness
condamned|condemned
condemmed|condemned
condidtion|condition
condidtions|conditions
conected|connected
conection|connection
conesencus|consensus
confidental|confidential
confortable|comfortable
congradulations|congratulations
congresional|congressional
conscent|consent
consciouness|consciousness
consdider|consider
consdidered|considered
consdiered|considered
consectutive|consecutive
consentrate|concentrate
consentrated|concentrated
consept|concept
consequeseces|consequences
consern|concern
conserned|concerned
conserning|concerning
conservitive|conservative
consiciousness|consciousness
consicousness|consciousness
considerd|considered
consideres|considered
consious|conscious
consistant|consistent
consistantly|consistently
consitution|constitution
consitutional|constitutional
consorcium|consortium
constanly|constantly
constatn|constant
constinually|continually
constituion|constitution
constituional|constitutional
consttruction|construction
constuction|construction
consulant|consultant
containes|contains
contendor|contender
contined|continued
continous|continuous
continously|continuously
continueing|continuing
contravercial|controversial
contraversy|controversy
contributer|contributor
contributers|contributors
contritutions|contributions
controled|controlled
controling|controlling
controll|control
controlls|controls
controvercial|controversial
controvercy|controversy
controversal|controversial
controversey|controversy
controvertial|controversial
controvery|controversy
contruction|construction
conveinent|convenient
convential|conventional
convertion|conversion
conviced|convinced
convienient|convenient
coorperation|cooperation
coorperations|corporations
copmetitors|competitors
coputer|computer
copywrite|copyright
cornmitted|committed
corparate|corporate
corperations|corporations
correspondant|correspondent
corridoors|corridors
corrispondant|correspondent
costitution|constitution
coucil|council
coudl|cloud
couldnt|couldn't
councellor|counselor
counries|countries
countains|contains
countires|countries
countrie's|countries
coverted|converted
cpoy|copy
creaeted|created
criterias|criteria
criticists|critics
critising|criticizing
critisism|criticism
critisize|criticize
critisized|criticized
critisizing|criticizing
critized|criticized
critizing|criticizing
crowm|crown
crtical|critical
curch|church
curcuit|circuit
currenly|currently
dael|deal
damenor|demeanor
decendant|descendant
decendent|descendant
decidely|decidedly
decieved|deceived
decison|decision
decribe|describe
decribed|described
decribes|describes
decribing|describing
dectect|detect
defendent|defendant
defendents|defendants
deffensively|defensively
deffine|define
deffined|defined
definance|defiance
definate|definite
definately|definitely
definatly|definitely
definetly|definitely
definining|defining
definit|definite
definitly|definitely
definiton|definition
defintion|definition
delagates|delegates
delevopment|development
deliberatly|deliberately
demenor|demeanor
demographical|demographic
demorcracy|democracy
demostration|demonstration
deparment|department
deparments|departments
dependant|dependent
deram|dream
descibed|described
descision|decision
descisions|decisions
descriibes|describes
descripton|description
desctruction|destruction
descuss|discuss
desgined|designed
deside|decide
desigining|designing
desitned|destined
desktiop|desktop
desorder|disorder
desparate|desperate
despatched|dispatched
despiration|desperation
dessigned|designed
destory|destroy
detailled|detailed
detatched|detached
deterioriating|deteriorating
determinining|determining
devasted|devastated
develope|develop
developement|development
developped|developed
develpment|development
devestated|devastated
devestating|devastating
devide|divide
devided|divided
devistating|devastating
devolopement|development
diamons|diamonds
diaster|disaster
dicover|discover
dicovered|discovered
dicovering|discovering
dicovery|discovery
dicussed|discussed
didnt|didn't
diea|die
dieing|dying
diferent|different
diferrent|different
differnt|different
difficulity|difficulty
diffrent|different
dificulties|difficulties
dificulty|difficulty
dimenions|dimensions
dimention|dimension
dimentional|dimensional
dimentions|dimensions
dimesnional|dimensional
diplomancy|diplomacy
disagreeed|disagreed
disapeared|disappeared
disapointing|disappointing
disappearred|disappeared
disaproval|disapproval
disasterous|disastrous
disatrous|disastrous
discribe|describe
discribed|described
discribes|describes
discribing|describing
disctinction|distinction
disctinctive|distinctive
disiplined|disciplined
disolved|dissolved
disover|discover
dispair|despair
dispite|despite
disricts|districts
dissagreement|disagreement
dissapear|disappear
dissapearance|disappearance
dissapeared|disappeared
dissapearing|disappearing
dissapears|disappears
dissappear|disappear
dissappears|disappears
dissappointed|disappointed
dissarray|disarray
distiction|distinction
distingish|distinguish
distrubution|distribution
distruction|destruction
distructive|destructive
ditributed|distributed
diversed|diverse
divice|device
divison|division
divisons|divisions
doccument|document
doccumented|documented
doccuments|documents
documenatry|documentary
doens|does
doesnt|doesn't
doign|doing
dominaton|domination
dominent|dominant
dominiant|dominant
donig|doing
dont|don't
doub|doubt
doulbe|double
dowloads|downloads
dramtic|dramatic
dreasm|dreams
driectly|directly
drnik|drink
durig|during
durring|during
duting|during
eahc|each
ealier|earlier
earlies|earliest
earnt|earned
eceonomy|economy
eclispe|eclipse
ecomonic|economic
eearly|early
efel|evil
effeciency|efficiency
effecient|efficient
effeciently|efficiently
efficency|efficiency
efficent|efficient
efficently|efficiently
efford|afford
effords|efforts
eigth|eight
eiter|either
elction|election
electic|electric
electon|election
electrial|electrical
electricty|electricity
elementay|elementary
eleminated|eliminated
eleminating|eliminating
eletricity|electricity
eligable|eligible
elimentary|elementary
ellected|elected
elphant|elephant
embarass|embarrass
embarassed|embarrassed
embarassing|embarrassing
embarassment|embarrassment
embarras|embarrass
embarrased|embarrassed
embarrasing|embarrassing
embarrasment|embarrassment
emited|emitted
emiting|emitting
emition|emotion
emmediately|immediately
emminent|imminent
emmisions|emissions
emmited|emitted
emmiting|emitting
emmitted|emitted
emmitting|emitting
emphsis|emphasis
emprisoned|imprisoned
encouraing|encouraging
endig|ending
ened|need
engagment|engagement
engeneer|engineer
engeneering|engineering
engieneer|engineer
engieneers|engineers
Enlish|English
enourmous|enormous
enteratinment|entertainment
enthusiatic|enthusiastic
entitity|entity
entitlied|entitled
entrepeneur|entrepreneur
entrepeneurs|entrepreneurs
enviorment|environment
enviormental|environmental
enviornment|environment
enviornmental|environmental
enviroment|environment
enviromental|environmental
enxt|next
epidsodes|episodes
epsiode|episode
equialent|equivalent
equiped|equipped
equippment|equipment
equivelant|equivalent
equivelent|equivalent
equivilant|equivalent
equivilent|equivalent
equivlalent|equivalent
erally|really
eratic|erratic
erested|arrested
errupted|erupted
esential|essential
esitmated|estimated
esle|else
especialy|especially
essencial|essential
essense|essence
essentail|essential
essentialy|essentially
essentual|essential
essesital|essential
establising|establishing
ethose|those
evenhtually|eventually
eventally|eventually
eventially|eventually
eventualy|eventually
everthing|everything
everyting|everything
eveyr|every
evidentally|evidently
exagerated|exaggerated
exagerrated|exaggerated
examinated|examined
exampt|exempt
exapansion|expansion
excact|exact
excange|exchange
excecute|execute
excecuted|executed
excecution|execution
excedded|exceeded
excelent|excellent
excellant|excellent
excercise|exercise
exchanching|exchanging
excisted|existed
exculsivly|exclusively
exection|execution
exectued|executed
exelent|excellent
exellent|excellent
exemple|example
exept|except
exeptional|exceptional
exerciese|exercises
exersize|exercise
exerternal|external
exhibtion|exhibition
exibition|exhibition
exicting|exciting
existance|existence
existant|existent
existince|existence
exliled|exiled
exmaple|example
expalin|explain
expeced|expected
expecially|especially
expeiments|experiments
experiance|experience
experianced|experienced
expierence|experience
explaination|explanation
explaning|explaining
explictly|explicitly
exressed|expressed
extemely|extremely
extention|extension
extermist|extremist
extrememly|extremely
extremly|extremely
extrordinary|extraordinary
eyar|year
eyars|years
eyasr|years
facilites|facilities
facinated|fascinated
familes|families
familliar|familiar
famoust|famous
fatc|fact
faught|fought
fertily|fertility
fianlly|finally
fidn|find
fiel|feel
fiels|feels
fiercly|fiercely
fightings|fighting
fimilies|families
finacial|financial
finaly|finally
financialy|financially
firends|friends
firts|first
flawess|flawless
fleed|fled
fluorish|flourish
follwoing|following
folowing|following
fomed|formed
fomr|form
foootball|football
forbiden|forbidden
forhead|forehead
foriegn|foreign
formaly|formally
formelly|formerly
formidible|formidable
formost|foremost
foucs|focus
foudn|found
fougth|fought
fourty|forty
fouth|fourth
foward|forward
freind|friend
freindly|friendly
frequentily|frequently
frome|from
fromed|formed
fucntion|function
fucntioning|functioning
fufill|fulfill
fufilled|fulfilled
fulfiled|fulfilled
fullfill|fulfill
fullfilled|fulfilled
fundametal|fundamental
funtion|function
furuther|further
futher|further
gae|game
ganerate|generate
ganes|games
garantee|guarantee
garanteed|guaranteed
garantees|guarantees
gaurantee|guarantee
gauranteed|guaranteed
gaurantees|guarantees
gaurd|guard
gaurentee|guarantee
gaurenteed|guaranteed
gaurentees|guarantees
generaly|generally
generatting|generating
gerat|great
glight|flight
godess|goddess
gogin|going
goign|going
gonig|going
gouvener|governor
govement|government
govenment|government
govenrment|government
goverment|government
governer|governor
governmnet|government
govorment|government
govornment|government
gracefull|graceful
graet|great
grammer|grammar
grat|great
greatful|grateful
greatfully|gratefully
greif|grief
gropu|group
grwo|grow
guage|gauge
guarentee|guarantee
guarenteed|guaranteed
guarentees|guarantees
guerilla|guerrilla
guerrila|guerrilla
guidence|guidance
gurantee|guarantee
guranteed|guaranteed
gurantees|guarantees
hadnt|hadn't
haev|have
halp|help
hapen|happen
hapened|happened
hapening|happening
happend|happened
happended|happened
happenned|happened
harasment|harassment
harassement|harassment
harrasment|harassment
harrassment|harassment
hasnt|hasn't
havent|haven't
hed|he'd
headquaters|headquarters
heared|heard
heathy|healthy
heigher|higher
helment|helmet
helpfull|helpful
helpped|helped
herad|heard
heroe|hero
heros|heroes
hertiage|heritage
hes|he's
hesistant|hesitant
hieght|height
higer|higher
higest|highest
higway|highway
hillarious|hilarious
himselv|himself
hismelf|himself
holliday|holiday
horrifing|horrifying
hosited|hoisted
hounour|honour
housr|hours
housr|house
howve|how've
howver|however
hstory|history
hten|hen
htere|here
htey|they
htikn|think
hting|thing
htink|think
htis|this
humer|humor
humerous|humorous
humurous|humorous
husban|husband
hvae|have
hvaing|having
hvea|have
hwihc|which
hwile|while
hwole|whole
i|I
id|I'd
idaeidae|idea
idaes|ideas
identicial|identical
idesa|ideas
ill|I'll
illess|illness
illiegal|illegal
illution|illusion
ilness|illness
im|I'm
imagenary|imaginary
imagin|imagine
imaginery|imaginary
imanent|imminent
imcomplete|incomplete
imediately|immediately
imense|immense
imigrant|immigrant
imigration|immigration
iminent|imminent
immediatley|immediately
immediatly|immediately
immidately|immediately
immidiately|immediately
impliment|implement
implimented|implemented
importamt|important
imprioned|imprisoned
imprisonned|imprisoned
improvments|improvements
inablility|inability
inadiquate|inadequate
inadquate|inadequate
inappropiate|inappropriate
inbetween|between
inclreased|increased
includ|include
includng|including
increadible|incredible
incredable|incredible
inctroduce|introduce
inctroduced|introduced
incuding|including
indefinately|indefinitely
indefinitly|indefinitely
indentical|identical
indepedantly|independently
indepedence|independence
independance|independence
independant|independent
independantly|independently
independece|independence
independendet|independent
indictement|indictment
indipendence|independence
indipendent|independent
indipendently|independently
indpendent|independent
indpendently|independently
indulgue|indulge
indutrial|industrial
indviduals|individuals
inevatible|inevitable
inevitible|inevitable
inevititably|inevitably
infectuous|infectious
infinit|infinite
influencial|influential
influented|influenced
infomation|information
informtion|information
infrigement|infringement
ingreediants|ingredients
inhabitans|inhabitants
inheritage|heritage
inital|initial
initally|initially
initiaitive|initiative
inlcuding|including
inmigrant|immigrant
inmigrants|immigrants
inocence|innocence
inofficial|unofficial
inot|into
inproving|improving
inseperable|inseparable
insitution|institution
insitutions|institutions
inspite|inspire
instade|instead
instatance|instance
instuction|instruction
instuments|instruments
insurence|insurance
intelectual|intellectual
inteligence|intelligence
inteligent|intelligent
intenational|international
intented|intended
intepretation|interpretation
interational|international
interferance|interference
intergrated|integrated
intergration|integration
interm|interim
internation|international
interrim|interim
intertaining|entertaining
interupt|interrupt
intevene|intervene
intial|initial
intially|initially
intrduced|introduced
intrest|interest
introdued|introduced
intruduced|introduced
intrument|instrument
intruments|instruments
inudstry|industry
inventer|inventor
investingate|investigate
involvment|involvement
irelevent|irrelevant
iresistable|irresistible
iresistible|irresistible
iritated|irritated
ironicly|ironically
irregardless|regardless
irrelevent|irrelevant
irresistable|irresistible
isnt|isn't
issueing|issuing
itd|it'd
itll|it'll
itnroduced|introduced
its|it's
iunior|junior
ive|I've
iwll|will
iwth|with
jeapardy|jeopardy
jouney|journey
jstu|just
jsut|just
judical|judicial
juducial|judicial
juristiction|jurisdiction
kindergarden|kindergarten
knifes|knives
knive|knife
knowlege|knowledge
knwo|know
knwos|knows
konw|know
konws|knows
kwno|know
labatory|laboratory
labled|labeled
labratory|laboratory
laguage|language
laguages|languages
larg|large
largst|largest
lastr|last
launchs|launch
launhed|launched
layed|laid
leage|league
leanr|lean
leathal|lethal
lefted|left
legitamate|legitimate
legitmate|legitimate
lenght|length
leran|learn
lerans|learns
leutenant|lieutenant
levle|level
libary|library
lieing|lying
liek|like
liekd|liked
lieuenant|lieutenant
lieved|lived
liftime|lifetime
likelyhood|likelihood
liscense|license
lisence|license
lisense|license
litature|literature
literture|literature
littel|little
litterally|literally
liuke|like
livley|lively
lmits|limits
loev|love
lonelyness|loneliness
lonley|lonely
lonly|lonely
loosing|losing
lsat|last
lveo|love
lvoe|love
maching|machine
magasine|magazine
magincian|magician
magnificient|magnificent
mailny|mainly
maintainance|maintenance
maintainence|maintenance
maintance|maintenance
maintenence|maintenance
maintinaing|maintaining
maintioned|mentioned
majoroty|majority
maked|made
makse|makes
managment|management
manouver|maneuver
mantained|maintained
manuever|maneuver
manufaturing|manufacturing
manuver|maneuver
mariage|marriage
marjority|majority
markes|marks
marketting|marketing
marrage|marriage
marraige|marriage
marryied|married
mchanics|mechanics
meaninng|meaning
mear|mere
mechandise|merchandise
medacine|medicine
memeber|member
menally|mentally
messanger|messenger
messenging|messaging
metalic|metallic
mileau|milieu
mileu|milieu
miliary|military
milion|million
miliraty|military
millioniare|millionaire
millitary|military
millon|million
miltary|military
minature|miniature
ministery|ministry
minstry|ministry
minumum|minimum
mirrorred|mirrored
mischeivous|mischievous
mischevious|mischievous
mischievious|mischievous
misdameanor|misdemeanor
misdemenor|misdemeanor
misile|missile
missle|missile
misterious|mysterious
mistery|mystery
misteryous|mysterious
mkae|make
mkaes|makes
mkaing|making
mkea|make
modle|model
moent|moment
moeny|money
moil|soil
monestary|monastery
montains|mountains
monts|months
moreso|more
morgage|mortgage
mosture|moisture
motiviated|motivated
mounth|month
movei|movie
movment|movement
mr|Mr.
mroe|more
mrs|Mrs.
ms|Ms.
muder|murder
mudering|murdering
munbers|numbers
muscels|muscles
muscial|musical
muscician|musician
muscicians|musicians
mustnt|mustn't
myraid|myriad
mysef|myself
mysterous|mysterious
naieve|naive
naturaly|naturally
naturely|naturally
naturual|natural
naturually|naturally
neccesarily|necessarily
neccesary|necessary
neccessarily|necessarily
neccessary|necessary
neccessities|necessities
necesarily|necessarily
necesary|necessary
neednt|needn't
negociate|negotiate
negociations|negotiations
neice|nice
neigborhood|neighborhood
neigbour|neighbor
neigbouring|neighboring
neigbours|neighbors
nessasarily|necessarily
nessecary|necessary
neverthless|nevertheless
nightime|nighttime
nineth|ninth
ninty|ninety
nkow|know
nkwo|know
nmae|name
nonsence|nonsense
nontheless|nonetheless
norhern|northern
northen|northern
notabley|notably
noteable|notable
noteably|notably
noth|north
nothern|northern
noticable|noticeable
noticably|noticeably
noticeing|noticing
noticible|noticeable
noveau|nouveau
nowdays|nowadays
nowe|now
nto|not
nucular|nuclear
nuculear|nuclear
nuisanse|nuisance
numberous|numerous
nusance|nuisance
obession|obsession
obssessed|obsessed
obstacal|obstacle
obstancles|obstacles
ocasion|occasion
ocasional|occasional
ocasionally|occasionally
ocasionaly|occasionally
ocasions|occasions
ocassion|occasion
ocassional|occasional
ocassionally|occasionally
ocassionaly|occasionally
ocassions|occasions
occaison|occasion
occassion|occasion
occassional|occasional
occassionally|occasionally
occassionaly|occasionally
occassions|occasions
occationally|occasionally
occour|occur
occurance|occurrence
occured|occurred
occurence|occurrence
occuring|occurring
occurr|occur
occurrance|occurrence
ocuntries|countries
ocuntry|country
ocurr|occur
ocurrance|occurrence
ocurred|occurred
ocurrence|occurrence
offcers|officers
offcially|officially
offereings|offerings
offical|official
offically|officially
officals|officials
officaly|officially
officialy|officially
offred|offered
oftenly|often
oging|going
omre|more
onot|not
onyl|only
openess|openness
oponent|opponent
oportunity|opportunity
opose|oppose
oposite|opposite
oposition|opposition
oppenly|openly
oppinion|opinion
opponant|opponent
oppononent|opponent
oppositition|opposition
oppossed|opposed
opprotunity|opportunity
optomism|optimism
orded|ordered
organiztion|organization
orgin|organ
orginal|original
orginally|originally
origanaly|originally
originall|original
originaly|originally
originially|originally
originnally|originally
origional|original
orignally|originally
orignially|originally
otehr|other
oustanding|outstanding
overshaddowed|overshadowed
overwelming|overwhelming
overwheliming|overwhelming
owrk|work
owudl|would
oxigen|oxygen
p0enis|penis
paide|paid
paitience|patience
palce|palace
paralel|parallel
paralell|parallel
parituclar|particular
parliment|parliament
parralel|parallel
parrallel|parallel
parrallell|parallel
partialy|partially
particually|particularly
particualr|particular
particuarly|particularly
particularily|particularly
particulary|particularly
pary|party
pased|passed
pasengers|passengers
paticular|particular
payed|paid
peageant|pageant
peculure|peculiar
peice|piece
penatly|penalty
peom|poem
peoms|poems
peopel|people
peotry|poetry
perade|parade
percepted|perceived
percieved|perceived
performence|performance
performes|performed
perhasp|perhaps
perheaps|perhaps
perhpas|perhaps
peristent|persistent
perjery|perjury
permanant|permanent
permenant|permanent
permenantly|permanently
peronal|personal
perosnality|personality
perphas|perhaps
persistant|persistent
personel|personal
personell|personnel
personnell|personnel
persuded|persuaded
persue|pursue
persued|pursued
persuing|pursuing
persuit|pursuit
petetion|petition
phenomenom|phenomenon
phenomonenon|phenomenon
phenomonon|phenomenon
philisophy|philosophy
philosphy|philosophy
physicaly|physically
pich|pitch
pinapple|pineapple
pinnaple|pineapple
planed|planned
plausable|plausible
pleasent|pleasant
plesant|pleasant
poenis|penis
poeoples|peoples
poety|poetry
poisin|poison
polical|political
politican|politician
politicans|politicians
poltical|political
polution|pollution
pomotion|promotion
popoulation|population
popularaty|popularity
populare|popular
populer|popular
portait|portrait
portayed|portrayed
posess|possess
posessed|possessed
posession|possession
posessions|possessions
posion|poison
positon|position
possable|possible
possably|possibly
possesion|possession
possibile|possible
possibilty|possibility
possiblility|possibility
possiblilty|possibility
possiblities|possibilities
possiblity|possibility
possition|position
postion|position
postive|positive
potatos|potatoes
potrait|portrait
potrayed|portrayed
poulations|populations
poverful|powerful
poweful|powerful
powerfull|powerful
practial|practical
practially|practically
practicaly|practically
practicly|practically
pratice|practice
precedessor|predecessor
preceeded|preceded
precentage|percentage
precice|precise
precisly|precisely
predicatble|predictable
predicitons|predictions
prefered|preferred
prefering|preferring
preiod|period
premeire|premiere
premission|permission
prepair|prepare
prepartion|preparation
preperation|preparation
preperations|preparations
preriod|period
presedential|presidential
presense|presence
presidenital|presidential
presidental|presidential
presitgious|prestigious
prespective|perspective
prestigeous|prestigious
prestigous|prestigious
presumabely|presumably
presumibly|presumably
pretection|protection
previvous|previous
pricipal|principal
priciple|principle
primarly|primarily
privelege|privilege
privelige|privilege
privilage|privilege
priviledge|privilege
privledge|privilege
privte|private
probablly|probably
probaly|probably
probelm|problem
proccess|process
proccessing|processing
procede|proceed
proceded|preceded
procedes|proceeds
procedger|procedure
procedings|proceedings
proceedure|procedure
proces|process
processer|processor
proclamed|proclaimed
profesion|profession
profesor|professor
professer|professor
proffesion|profession
proffesional|professional
proffesor|professor
progessed|progressed
progrom|program
progroms|programs
prominant|prominent
promotted|promoted
pronouced|pronounced
pronounched|pronounced
proove|prove
prooved|proved
prophacy|prophecy
propmted|prompted
propostion|proposition
propper|proper
propperly|properly
protocal|protocol
protrayed|portrayed
provded|provided
provicial|provincial
provinicial|provincial
provisiosn|provision
proximty|proximity
psycology|psychology
psyhic|psychic
publically|publicly
publicaly|publicly
puchasing|purchasing
pumkin|pumpkin
purposedly|purposely
pursuade|persuade
pursuaded|persuaded
puting|putting
pwoer|power
pyscic|psychic
qtuie|quiet
questonable|questionable
quicklyu|quickly
quitted|quit
qutie|quiet
r|are
raelly|really
reacing|reaching
reacll|recall
realitvely|relatively
realsitic|realistic
realtions|relations
realy|really
realyl|really
reasearch|research
rebiulding|rebuilding
rebounce|rebound
reccomend|recommend
reccomendations|recommendations
reccomended|recommended
reccommend|recommend
reccommended|recommended
receving|receiving
reched|reached
recided|resided
recident|resident
recidents|residents
recieve|receive
recieved|received
reciever|receiver
recievers|receivers
recieves|receives
recieving|receiving
recived|received
recogise|recognise
recogize|recognize
recomend|recommend
recomended|recommended
recomends|recommends
recommedations|recommendations
reconcilation|reconciliation
reconized|recognized
recquired|required
recrod|record
recuiting|recruiting
rediculous|ridiculous
refect|reflect
refered|referred
referiang|referring
refering|referring
refernces|references
referrence|reference
referrs|refers
reffered|referred
refference|reference
refrence|reference
refrences|references
refrers|refers
refridgerator|refrigerator
refusla|refusal
regardes|regards
regluar|regular
reguarly|regularly
regulaion|regulation
regulaotrs|regulators
regularily|regularly
rehersal|rehearsal
reknowned|renowned
rela|real
relaly|really
relatiopnship|relationship
relativly|relatively
releive|relieve
releived|relieved
releiver|reliever
releses|releases
relevent|relevant
religeous|religious
religous|religious
relitavely|relatively
relized|realised
relpacement|replacement
remaing|remaining
remeber|remember
rememberable|memorable
remenicent|reminiscent
reminescent|reminiscent
reminscent|reminiscent
reminsicent|reminiscent
rendevous|rendezvous
rendezous|rendezvous
repeteadly|repeatedly
repid|rapid
reponse|response
reponsible|responsible
reportadly|reportedly
represantative|representative
representive|representative
representives|representatives
repsectively|respectively
requirment|requirement
requred|required
resaurant|restaurant
resembelance|resemblance
resembes|resembles
resemblence|resemblance
residental|residential
resistence|resistance
resistent|resistant
respectivly|respectively
responce|response
responibilities|responsibilities
responisble|responsible
responnsibilty|responsibility
responsability|responsibility
responsibile|responsible
responsibilites|responsibilities
responsiblity|responsibility
ressemblance|resemblance
ressemble|resemble
ressembled|resembled
ressemblence|resemblance
ressembling|resembling
restarant|restaurant
restarants|restaurants
restaraunt|restaurant
restaraunts|restaurants
restauraunt|restaurant
resteraunt|restaurant
resteraunts|restaurants
resticted|restricted
restraunt|restaurant
resturant|restaurant
resturants|restaurants
resturaunt|restaurant
resturaunts|restaurants
retalitation|retaliation
retreive|retrieve
returnd|returned
revolutionar|revolutionary
rewriet|rewrite
rhythem|rhythm
rhythim|rhythm
rininging|ringing
rised|rose
rocord|record
roomate|roommate
rougly|roughly
rulle|rule
runing|running
runnung|running
rwite|write
rythem|rhythm
rythim|rhythm
rythm|rhythm
sacrafice|sacrifice
saftey|safety
safty|safety
salery|salary
sandwhich|sandwich
sargant|sergeant
sargeant|sergeant
sasy|says
satelite|satellite
satelites|satellites
sattelite|satellite
sattelites|satellites
saught|sought
saveing|saving
schedual|schedule
scholarhip|scholarship
scientfic|scientific
scientifc|scientific
scientis|scientist
scince|science
scinece|science
scirpt|script
scoll|scroll
scrutinity|scrutiny
seach|search
seached|searched
seaches|searches
secceeded|succeeded
seceed|succeed
seceeded|succeeded
secratary|secretary
secretery|secretary
seeked|sought
seing|seeing
seinor|senior
seldomly|seldom
senarios|scenarios
sence|sense
senstive|sensitive
seperate|separate
seperated|separated
seperately|separately
seperating|separating
seperation|separation
seperatist|separatist
sergent|sergeant
settelement|settlement
settlment|settlement
severeal|several
severley|severely
severly|severely
sevice|service
shaddow|shadow
sheat|cheat
sheild|shield
sherif|sheriff
shes|she's
shineing|shining
shiped|shipped
shiping|shipping
shorly|shortly
shoudl|should
shoudln|should
shouldnt|shouldn't
shreak|shriek
shrinked|shrunk
sicne|since
sieze|seize
siezed|seized
siezing|seizing
siginificant|significant
signficant|significant
signficiant|significant
signifantly|significantly
significently|significantly
signifigant|significant
signifigantly|significantly
similarily|similarly
similiar|similar
similiarly|similarly
simmilar|similar
simpley|simply
simplier|simpler
simultanously|simultaneously
sincerley|sincerely
sinse|since
skateing|skating
slowy|slowly
smae|same
smoe|some
soem|some
sofware|software
sohw|show
soilders|soldiers
solatary|solitary
soley|solely
soliders|soldiers
somene|someone
somtimes|sometimes
somwhere|somewhere
sophicated|sophisticated
sophmore|sophomore
sorrounding|surrounding
sotry|story
sotyr|story
soudn|sound
soudns|sounds
sould|could
sourth|south
sourthern|southern
souvenier|souvenir
souveniers|souvenirs
sovereignity|sovereignty
soverign|sovereign
soverignity|sovereignty
soverignty|sovereignty
speach|speech
specfic|specific
speciallized|specialized
specif|specific
spectauclar|spectacular
spects|aspects
spectum|spectrum
speices|species
spoace|space
sponser|sponsor
sponsered|sponsored
spontanous|spontaneous
sponzored|sponsored
sppeches|speeches
spreaded|spread
sprech|speech
spred|spread
spriritual|spiritual
spritual|spiritual
sqaure|square
stablility|stability
staion|station
standars|standards
stange|strange
startegic|strategic
startegies|strategies
startegy|strategy
statememts|statements
statment|statement
steriods|steroids
stiring|stirring
stlye|style
stong|strong
stopry|story
storeis|stories
storise|stories
stornegst|strongest
stoyr|story
stpo|stop
stradegies|strategies
stradegy|strategy
strat|start
stregth|strength
strenghen|strengthen
strenghened|strengthened
strenghening|strengthening
strenght|strength
strenghten|strengthen
strenghtened|strengthened
strenghtening|strengthening
strengtened|strengthened
strnad|strand
stroy|destroy
stucture|structure
stuctured|structured
studdy|study
studing|studying
stuggling|struggling
sturcture|structure
subconsiously|subconsciously
subsidary|subsidiary
subsiduary|subsidiary
subsquent|subsequent
subsquently|subsequently
substace|substance
substancial|substantial
substatial|substantial
subtances|substances
suburburban|suburban
succceeded|succeeded
succedded|succeeded
succeded|succeeded
succesful|successful
succesfully|successfully
succesfuly|successfully
succesion|succession
succesive|successive
successfull|successful
successully|successfully
succsess|success
succsessfull|successful
suceed|succeed
suceeded|succeeded
suceeding|succeeding
sucesful|successful
sucesfully|successfully
sucesfuly|successfully
sucesion|succession
sucess|success
sucessful|successful
sucessfull|successful
sucessfully|successfully
sucessfuly|successfully
sucession|succession
sucessive|successive
sucessor|successor
sucessot|successor
sucide|suicide
sucidial|suicidal
sufferred|suffered
sufferring|suffering
sufficent|sufficient
sumary|summary
sunglases|sunglasses
suop|soup
suphisticated|sophisticated
supose|suppose
suposed|supposed
suposedly|supposedly
suppoed|supposed
supposingly|supposedly
suppy|supply
supress|suppress
supressed|suppressed
supressing|suppressing
suprise|surprise
suprised|surprised
suprising|surprising
suprisingly|surprisingly
suprize|surprise
suprized|surprised
suprizing|surprising
suprizingly|surprisingly
surfce|surface
surley|surely
suround|surround
surounded|surrounded
surounding|surrounding
suroundings|surroundings
surpress|suppress
surpressed|suppressed
surprize|surprise
surprized|surprised
surprizing|surprising
surprizingly|surprisingly
surrended|surrendered
surronded|surrounded
surrouded|surrounded
surrouding|surrounding
surveilence|surveillance
surviver|survivor
survivers|survivors
survivied|survived
suspention|suspension
swaer|swear
swaers|swears
swepth|swept
swiming|swimming
syas|says
sypmtoms|symptoms
sytem|system
sytle|style
tabacco|tobacco
tahn|than
taht|that
talekd|talked
targetted|targeted
targetting|targeting
tast|taste
tath|that
tattooes|tattoos
teached|taught
techiniques|techniques
technnology|technology
technolgy|technology
teh|the
tehy|they
telelevision|television
televsion|television
temerature|temperature
temperarily|temporarily
tempertaure|temperature
temperture|temperature
temprary|temporary
tendacy|tendency
tendancy|tendency
tepmorarily|temporarily
terriories|territories
terriory|territory
territorist|terrorist
territoy|territory
terroist|terrorist
tghe|the
thast|that
thats|that's
thatll|that'll
thatd|that'd
theather|theater
theese|these
theif|thief
theives|thieves
themselfs|themselves
themslves|themselves
ther|the
theri|their
thered|there'd
theres|there's
therell|there'll
theyre|they're
theyll|they'll
theyd|they'd
theyve|they've
thgat|that
thge|the
thier|their
thign|thing
thigns|things
thigsn|things
thikn|think
thikning|thinking
thikns|thinks
thiunk|think
thn|then
thna|than
thne|then
thnig|thing
thnigs|things
thoughout|throughout
threatend|threatened
threatning|threatening
threee|three
threshhold|threshold
thrid|third
throrough|thorough
throughly|thoroughly
throught|thought
througout|throughout
thru|through
thsi|this
thsoe|those
thta|that
thyat|that
tiem|time
tihkn|think
tihs|this
timne|time
tiome|time
tje|the
tjhe|the
tkae|take
tkaes|takes
tkaing|taking
tlaking|talking
tobbaco|tobacco
todya|today
toghether|together
tolerence|tolerance
tomatos|tomatoes
tommorow|tomorrow
tommorrow|tomorrow
tongiht|tonight
toubles|troubles
tounge|tongue
tourch|torch
towords|towards
towrad|toward
tradionally|traditionally
traditionaly|traditionally
traditionnal|traditional
traditition|tradition
tradtionally|traditionally
trafic|traffic
tranform|transform
tranformed|transformed
transfered|transferred
transfering|transferring
transformaton|transformation
transistion|transition
transporation|transportation
triguered|triggered
troups|troops
truely|truly
turnk|trunk
tust|trust
twon|town
twpo|two
tyhat|that
tyhe|they
typcial|typical
typicaly|typically
u|you
uise|use
ultimely|ultimately
unahppy|unhappy
unanymous|unanimous
unbeleivable|unbelievable
uncertainity|uncertainty
unconcious|unconscious
unconciousness|unconsciousness
unconfortability|discomfort
understoon|understood
undoubtely|undoubtedly
undreground|underground
uneccesary|unnecessary
unecessary|unnecessary
unforetunately|unfortunately
unfortunatley|unfortunately
unfortunatly|unfortunately
unfourtunately|unfortunately
univeral|universal
univeristies|universities
univeristy|university
univerity|university
universtiy|university
univesities|universities
univesity|university
unkown|unknown
unlikey|unlikely
unneccesary|unnecessary
unneccessary|unnecessary
unnecesary|unnecessary
unoffical|unofficial
unplesant|unpleasant
unprecendented|unprecedented
unprecidented|unprecedented
unsed|unused
unsuccesful|unsuccessful
unsuccessfull|unsuccessful
unsucesful|unsuccessful
unsucessful|unsuccessful
unsucessfull|unsuccessful
untill|until
unviersity|university
upcomming|upcoming
upgradded|upgraded
usally|usually
useage|usage
usefull|useful
useing|using
usualy|usually
ususally|usually
vaccum|vacuum
vaccume|vacuum
vacinity|vicinity
valuble|valuable
valueable|valuable
variey|variety
varity|variety
vegitable|vegetable
vegitables|vegetables
vegtable|vegetable
vehicule|vehicle
vell|well
vengance|vengeance
vengence|vengeance
verison|version
verisons|versions
vetween|between
veyr|very
vigourous|vigorous
villian|villain
villin|villain
vincinity|vicinity
violentce|violence
virtualy|virtually
virutal|virtual
virutally|virtually
visable|visible
visably|visibly
visting|visiting
vistors|visitors
vitories|victories
volcanoe|volcano
volontary|voluntary
volonteer|volunteer
volonteered|volunteered
volonteers|volunteers
volounteer|volunteer
volounteered|volunteered
volounteers|volunteers
volumne|volume
vreity|variety
vrey|very
vriety|variety
vulnerablility|vulnerability
vyer|very
vyre|very
waht|what
wardobe|wardrobe
warrent|warrant
warrriors|warriors
wasnt|wasn't
wass|was
watn|want
weaponary|weaponry
weas|was
wehn|when
weild|wield
wereabouts|whereabouts
werent|weren't
weve|we've
whant|want
whants|wants
whats|what's
whcih|which
wheras|whereas
wherease|whereas
whereever|wherever
whic|which
whihc|which
whith|with
whlch|which
whn|when
wholey|wholly
wholy|holy
whta|what
whther|whether
wich|which
widesread|widespread
wief|wife
wierd|weird
wiew|view
wih|with
wiht|with
wille|will
willingless|willingness
wirting|writing
withdrawl|withdraw
withing|within
witht|with
witn|with
wiull|will
wnat|want
wnated|wanted
wnats|wants
wohle|whole
wokr|work
wokring|working
wonderfull|wonderful
wont|won't
wordlwide|worldwide
worls|world
worstened|worsened
woudl|would
wouldnt|wouldn't
wriet|write
writen|written
wroet|wrote
wrok|work
wroking|working
ws|was
wtih|with
wupport|support
yatch|yacht
yearm|year
yeasr|years
yeild|yield
yera|year
yeras|years
yersa|years
yinz|you
youd|you'd
youll|you'll
youre|you're
yous|you
youself|yourself
youve|you've
ytou|you
yuo|you

# From FAWTHROP2DAT.643
ablity|ability
academicly|academically
acept|accept
acepted|accepted
acess|access
accessability|accessibility
accesing|accessing
acompaning|accompanying
acording|according
acount|account
acounts|accounts
acumulated|accumulated
aquantences|acquaintances
adabtable|adaptable
addresable|addressable
adiquate|adequate
adequattly|adequately
adjurnment|adjournment
advantageos|advantageous
advice|advise
agiin|again
agences|agencies
agravating|aggravating
alow|allow
athough|although
analiss|analyse
analised|analysed
aalysing|analysing
analisis|analysis
analiss|analysis
analsis|analysis
anf|and
anouncement|announcement
anouncing|announcing
anoying|annoying
anual|annual
anomolies|anomalies
appologies|apologies
appologised|apologised
apparant|apparent
apeal|appeal
apendix|appendix
aplicable|applicable
upplied|applied
applieing|applying
appoitment|appointment
apointments|appointments
apreciated|appreciated
apreciation|appreciation
aproach|approach
aproached|approached
aproximatly|approximately
arte|are
aurguing|arguing
aranged|arranged
arrainged|arranged
aranging|arrangeing
arragment|arrangement
arrangment|arrangement
araingements|arrangements
articals|articles
accesing|assessing
assosiated|associated
atmospher|atmosphere
aurgument|auguments
auxillary|auxiliary
avaiblity|availability
avaible|available
availble|available
basse|base
befor|before
begining|beginning
belive|believe
benficial|beneficial
benificial|beneficial
benifit|benefit
benifits|benefits
beeteen|between
beetween|between
bicycal|bicycle
bingly|bingley
bonas|bonus
brif|brief
biuld|build
biulding|building
buisy|busy
cancelation|cancellation
carear|career
carrer|career
carrers|careers
currers|careers
catagoris|categories
centraly|centrally
cirtain|certain
chalenges|challenges
chalange|challenge
chalenges|challenges
choise|choice
choises|choices
chose|choose
chosing|choosing
clearical|clerical
cleark|clerk
clerck|clerk
colate|collate
comibine|combine
comersial|commercial
coments|comments
comit|commit
comittee|committee
committe|committee
comittees|committees
commitees|committees
compair|compare
compased|compared
comppared|compared
comparrison|comparison
completly|completely
componant|component
compossed|composed
concieved|conceived
conditining|conditioning
conferance|conference
confermation|confirmation
concider|consider
conciderable|considerable
consisit|consist
consisiting|consisting
consisits|consists
contasined|contained
containg|containing
contasining|containing
contually|continually
contuned|continued
controled|controlled
conversly|conversely
corparate|corporate
correspondance|correspondence
creadit|credit
citisum|criticism
curruntly|currently
dat|data
dsata|data
delt|dealt
descide|decide
descided|decided
descides|decides
descision|decision
descisions|decision
deciscions|decisions
descisions|decisions
declaratrions|declarations
defenition|definition
defenitions|definitions
diemands|demands
dependance|dependence
discite|discrete
describd|described
discribed|described
descvription|description
desription|description
discription|description
disiable|desirable
despratly|desperately
develope|develop
diagrammaticaally|diagrammatically
diffrent|different
dificult|difficult
dificulty|difficulty
disaggreaget|disaggregate
disaggreagte|disaggregate
dissapoiting|disappointing
disiplin|discipline
discresion|discretion
desacription|description
desention|dissension
doupt|doubt
draged|dragged
drasticaly|drastically
drasticly|drastically
earlyer|earlier
earlyest|earliest
easer|easier
easly|easily
easyly|easily
economtric|econometric
ediion|edition
ediition|edition
elegable|eligible
elimiated|eliminated
embelishing|embellishing
emploied|employed
emploies|employees
empolyment|employment
encompasing|encompassing
encorage|encourage
enomosly|enormously
entierly|entirely
equaled|equalled
errounous|erroneous
especaily|especially
esential|essential
eventully|eventually
evedent|evident
exsact|exact
exsactly|exactly
eximination|examination
examin|examine
exerlant|excellent
excxept|except
exessively|excessively
executted|executed
expanion|expansion
expence|expense
expencive|expensive
experances|experiences
experance|experience
experiance|experience
experances|experiences
explaning|explaining
exponentualy|exponentially
extreamly|extremely
extreemly|extremely
febuary|february
facilitys|facilities
failes|fails
faulse|false
familer|familiar
familes|families
familys|families
faverable|favourable
favorably|favourably
fealing|feeling
femail|female
figuar|figure
figuars|figures
finaly|finally
finatical|financial
financialy|financially
flexable|flexible
forbiden|forbidden
forcast|forecast
forien|foreign
forth|fourth
functionaly|functionally
functuions|functions
furhter|further
futher|further
ganing|gaining
generataed|generated
geniva|geneva
goegraphicaly|geographically
goverment|government
graphicaly|graphically
guidlines|guidelines
handel|handle
hierachial|hierarchal
hierachial|hierarchal
heiarky|hierarchy
hierchy|hierarchy
howeverr|however
humor|humour
idealy|ideally
imediate|immediate
imediatly|immediately
imidatly|immediately
inconcievable|inconceivable
indead|indeed
independant|independent
ineffiect|inefficient
intial|initial
intital|initial
inut|input
equiries|inquiries
insite|insight
inteligence|intelligence
intrest|interest
intresting|interesting
interpritation|interpretation
interogationg|interrogating
investegated|investigated
irrelavent|irrelevant
journaism|journalism
knowage|knowledge
knowlege|knowledge
largly|largely
latter|later
lengh|length
leval|level
levals|levels
liew|lieu
litriture|literature
livelyhood|livelihood
lones|loans
localy|locally
lonley|lonely
luckeley|luckily
majorty|majority
managment|management
manualy|manually
mony|many
mathematicaly|mathematically
matriiix|matrix
meen|mean
meens|means
ment|meant
muinets|minutes
muinutes|minutes
muiuets|minutes
missleading|misleading
monitering|monitoring
monthes|months
moveing|moving
nationaly|nationally
natior|nature
necasery|necessary
necassary|necessary
necassery|necessary
neccasary|necessary
neccassary|necessary
nessasary|necessary
nessisary|necessary
nessisitates|necessitates
nessesity|necessity
negligable|negligible
niether|neither
nite|night
normaly|normally
noe|now
numbuers|numbers
optaning|obtaining
ocasionaly|occasionally
occasionaly|occasionally
occure|occur
occureed|occurred
operatins|operations
opertor|operator
operaters|operators
oprators|operators
oppinion|opinion
oppotunities|opportunities
opertunity|opportunity
opperttunity|opportunity
oppertunity|opportunity
oppotunity|opportunity
ordenary|ordinary
oragnisation|organization
oranisation|organization
oranised|organized
orentated|orientated
oputput|output
overal|overall
payed|paid
perametres|parameters
partialy|partially
paerticulaur|particular
particulaur|particular
particulary|particularly
pattarns|patterns
pere|per
perhapse|perhaps
perminant|permanent
perminantly|permanently
personnell|personnel
personel|personnel
pivting|pivoting
plesent|pleasant
polatics|politics
possition|position
possablities|possibilities
possable|possible
prepaired|prepared
pimarily|primarily
piror|prior
proceduer|procedure
proceding|proceeding
preffeson|profession
proffit|profit
proffits|profits
progressess|progresses
progresion|progression
projeccts|projects
proprtions|proportions
provid|provide
provisionaly|provisionally
provisoe|proviso
quaties|qualities
quies|queries
questionare|questionnaire
reching|reaching
reajusted|readjusted
realy|really
recieve|receive
recieved|received
recived|received
recieves|receives
recives|receives
recieving|receiving
reciving|receiving
reciently|recently
recomend|recommend
recomendation|recommendation
recomending|recommending
reffered|refered
refereence|reference
refference|reference
regined|regained
rgister|register
relativly|relatively
relitivly|relatively
relavent|relevant
relevaant|relevant
repetative|repetitive
representitive|representative
rquested|requested
reequired|required
reserch|research
resoved|resolved
responsiblities|responsibilities
responcible|responsible
reulting|resulting
retirment|retirement
rouint|routine
safegaurd|safeguard
salarys|salaries
scheem|scheme
scrutiniesed|scrutinized
serch|search
serching|searching
secutaries|secretaries
seurity|security
seeen|seen
egment|segment
segemnt|segment
sienior|senior
sence|sense
sensable|sensible
seperate|separate
seporate|separate
seperated|separated
seperation|separation
sesion|session
et|set
sheertes|sheets
shortend|shortened
hown|shown
eign|sign
similar|simular
singulaur|singular
somone|someone
sorce|source
sorces|sources
speeking|speaking
stanerdizing|standardizing
stoped|stopped
studens|students
studing|studying
subsequant|subsequent
subsiquent|subsequent
subtrcat|subtract
succesful|successful
sucessful|successful
sucssuful|successful
sucessive|successive
sucsesive|successive
shuch|such
suufering|suffering
suficient|sufficient
sugested|suggested
sugestion|suggestion
sugests|suggests
suted|suited
sumarys|summarys
supervison|supervision
suplement|supplement
suplementary|supplementary
suplements|supplements
supposidly|supposedly
serounding|surrounding
seroundings|surroundings
suroundings|surroundings
servays|surveys
servaying|surveying
sysem|system
tasble|table
tecnique|technique
tecniques|techniques
tempory|temporary
hte|the
thi|the
thw|the
ther|their
thier|their
thear|there
therefoe|therefore
therefor|therefore
thermawere|thermawear
thermawhere|thermawear
thees|these
thess|these
thay|they
thorts|thoughts
throut|through
throuout|throughout
timeing|timing
tittles|titles
ro|to
togehter|together
totaly|totally
traditionaly|traditionally
trasactions|transactions
transfred|transferred
transportibility|transportability
triangulaur|triangular
umberalla|umbrella
unavailble|unavailable
understadable|understandable
unequaled|unequalled
unequivocaly|unequivocally
unfortunatly|unfortunately
unioun|union
uneque|unique
universaly|universally
unversity|university
unessasarily|unnecessarily
unessessay|unnecessary
unresloved|unresolved
untill|until
usedf|used
usful|useful
uers|user
usualy|usually
utalised|utilized
valubale|valuable
valuble|valuable
vaiable|variable
varable|variable
varible|variable
vairiant|variant
variatry|variety
vairious|various
vertually|virtually
vistor|visitor
vistors|visitors
volantary|voluntary
volantry|voluntary
voteing|voting
wepons|weapons
wagted|weighted
wer|were
where|were
whn|when
wheras|whereas
wether|whether
widly|widely
wil|will
withing|within
whould|would
writen|written
yesars|years
